8
8
10111101
11011001
00100100
11010101
00010001
01101101
00000000
11001111