8
8
11011010
10000000
01111111
10001001
10010001
11111110
00000001
01101101