10
10
1101111101
0001111001
0001111000
1110100111
1110100111
1110010111
1110010111
0001111000
1001111000
1011111011