10
10
1010010001
1111010110
0100000110
0101110101
1000011001
1101001001
1001101010
0110100010
1010101110
0010010001