10
10
1101111101
1100100011
0011011101
0010000101
1010110101
1010110110
0110000101
0011101100
1100110001
0100111011