8
8
01110010
01000011
10001100
10000100
01110000
01001100
10001011
11110010