10
10
1100101000
1100101110
1110000010
0001001110
1011110001
1000001001
0111001110
0101001000
0111000000
1000111111