8
8
11001011
11010011
00111100
10111100
00111101
00111100
11001011
11010011