10
10
1011111101
1101111011
0110110110
1011001101
0101111010
1110110111
0101001010
1011001101
0011111100
1110110111