12
12
000000110000
011110001111
010001001000
000101110000
111101001111
000000010001
001001011100
111011010000
100011001110
001000011000
011000000111
011011111011