12
12
111111111011
110010010101
101010010101
001001100000
100010010011
000101101010
000101101010
100010010001
011001100111
000110011000
101011110111
101011110111