8
8
00101101
11110001
00011101
11110001
01000100
01011111
11101001
10001000