14
14
11011001111011
11010000000001
10101111100100
01011111101011
01011111001011
10100000000010
10111111111101
01001011000000
01010100111100
10010110001011
10000001000011
00100101110101
01010100001011
11011011111100