12
12
011001100011
011001101001
011111101100
000000001110
111100110000
000011110111
010011110100
010000110011
111010000010
000001101000
101011011011
101001100011