12
12
100100100100
000000000001
011011011001
100100000010
000110011011
011001010100
100101100111
000110101000
011001001110
100101101001
000110000111
011001111011