12
12
100111111101
011000000000
010101110000
101100000111
100011011000
000000000001
111011110111
100000000000
001100010010
000000010010
110011001100
001100110011