12
12
111011101110
010001000100
000000000000
111010100001
100010110001
110010101001
100010100101
100010100011
100010100001
000000000000
000100010001
101110111011