8
8
11011011
00101100
11010010
10100111
10010001
01000010
10101101
10011010